{
    "data": [
    1,1,1,1,1,1,1,1,1,1,1,1,1,1,1,1,1,1,1,1,1,1,1,1,1,
    1,0,"75",0,0,"01",6,6,6,6,"01","72T3","72T3","72T3","72T3",1,0,0,"75",0,"72T3",0,0,"75",1,
    1,0,0,0,0,"01",6,6,6,6,"01","t",0,"t",0,1,0,0,0,0,0,0,0,0,1,
    1,0,0,0,0,"01",6,6,6,6,"01",0,0,0,0,1,0,0,0,0,0,0,0,0,1,
    5,0,0,0,0,"01",6,6,6,6,"01",0,0,0,0,1,0,0,0,0,0,0,0,"71T0",1,
    1,0,0,0,0,"01",6,6,6,6,"01",0,0,0,0,0,0,0,0,0,0,0,0,0,1,
    1,0,0,0,0,"01",6,6,6,6,"01",0,0,0,0,0,0,0,0,0,0,0,0,0,1,
    1,"76T2",0,0,0,"01",6,3,3,6,"01",0,0,0,0,0,0,0,0,0,0,0,0,"71T0",1,
    1,0,0,0,0,"01",6,6,6,6,"01",0,0,1,0,0,0,0,0,0,0,0,0,0,1,
    1,0,0,0,0,"01","01","01","01","01T","01",0,0,1,0,0,0,0,0,0,0,0,0,0,1,
    1,"76T2",0,0,0,0,0,0,0,0,0,0,0,1,0,0,0,0,0,0,0,0,0,0,1,
    1,0,0,0,0,0,0,0,0,0,1,1,1,1,1,1,4,1,1,1,1,1,1,1,1,
    1,1,0,0,0,0,0,0,0,0,1,0,0,0,0,0,0,0,0,0,0,"72T3","72T3",0,1,
    1,0,0,0,0,0,0,"char3","t","71T0",1,0,0,0,0,0,0,0,0,0,0,0,0,0,1,
    1,"76T2",0,0,0,0,0,0,0,0,1,0,0,"t",0,6,6,6,6,6,6,0,0,0,1,
    1,0,0,0,0,0,0,0,0,0,1,0,0,0,0,6,6,6,6,6,6,0,"72T3",0,1,
    1,0,0,0,0,"0HU20",0,0,0,0,1,"76T2",0,0,0,6,6,6,6,6,6,0,"72T3",0,1,
    1,4,1,1,1,1,1,1,1,4,1,1,1,0,0,6,6,6,6,6,6,0,"72T3",0,1,
    1,0,0,0,0,0,0,0,0,0,0,0,1,0,0,6,6,6,6,6,6,0,"72T3",0,1,
    1,"76T2",0,0,0,0,0,0,0,0,0,0,1,0,0,0,0,0,6,6,0,"72T3",0,0,1,
    1,0,0,0,0,0,0,0,"P",0,0,0,1,0,0,0,0,0,6,6,0,0,0,0,1,
    1,6,6,6,6,6,6,6,6,6,6,6,6,6,6,6,6,6,6,6,0,0,0,0,1,
    1,0,0,0,0,"KB",0,0,0,0,0,0,1,0,0,0,0,0,0,0,0,0,0,0,1,
    1,"76T2",0,0,0,0,0,0,0,0,0,0,1,"76T2",0,0,0,0,0,0,0,0,0,0,1,
    1,1,1,1,1,1,1,1,1,1,1,1,1,1,1,1,1,1,1,1,1,1,1,1,1],
    "height": 25,
    "width": 25
  }
  