{
    "data": [
    1,1,1,1,1,1,1,1,1,1,1,1,1,1,1,1,1,1,1,1,1,1,1,1,1,
    1,0,0,0,0,"01",6,6,6,6,"01",0,0,0,0,1,0,0,0,0,0,0,0,0,1,
    1,0,0,0,0,"01",6,6,6,6,"01",0,0,0,0,1,0,0,0,0,0,0,0,0,1,
    1,0,0,0,0,"01",6,6,6,6,"01",0,0,0,0,1,0,0,0,0,0,0,0,0,1,
    1,0,0,0,0,"01",6,6,6,6,"01",0,0,0,0,1,0,0,0,0,0,0,0,0,1,
    1,0,0,0,0,"01",6,6,6,6,"01",0,0,0,0,0,0,0,0,0,"char1",0,0,0,1,
    1,0,0,0,0,"01",6,6,6,6,"01",0,0,0,0,0,0,0,0,0,0,0,0,0,1,
    1,0,0,0,0,"01",6,3,3,6,"01",0,0,0,0,0,0,0,0,0,0,0,0,0,1,
    1,0,0,0,0,"01",6,6,6,6,"01",0,0,1,0,0,0,0,0,5,0,0,0,0,1,
    1,0,0,0,0,"01","01","01","01","01T","01",0,0,1,0,0,0,0,0,0,0,0,0,0,1,
    1,0,0,0,0,0,0,0,0,0,0,0,0,1,0,0,0,0,0,0,0,0,0,0,1,
    1,0,0,0,0,0,0,0,0,0,1,1,1,1,1,1,4,1,1,1,1,1,1,1,1,
    1,1,0,0,0,0,0,0,0,0,1,0,0,0,0,0,0,0,0,0,0,0,0,0,1,
    1,"t",0,0,0,0,0,0,"char3","71T1",1,0,0,0,0,0,0,0,0,0,0,0,0,0,1,
    1,0,0,0,0,0,0,0,0,0,1,0,0,0,0,6,6,6,6,6,6,0,0,0,1,
    1,"72T2",0,0,0,0,0,0,0,0,1,0,0,0,0,6,6,6,6,6,6,0,0,0,1,
    1,0,0,0,0,0,0,0,0,0,1,0,0,0,0,6,6,6,6,6,6,0,0,0,1,
    1,4,1,1,1,1,1,1,1,4,1,1,1,0,0,6,6,6,6,6,6,0,0,0,1,
    1,0,0,0,0,0,0,0,0,"P",0,0,1,0,0,6,6,6,6,6,6,0,0,0,1,
    1,0,"KB",0,0,0,0,0,0,0,0,0,1,0,0,0,0,0,6,6,0,0,0,0,1,
    1,0,0,0,0,0,0,0,0,0,0,0,1,0,0,0,0,0,6,6,0,0,0,0,1,
    1,6,6,6,6,6,6,6,6,6,6,6,6,6,6,6,6,6,6,6,0,0,0,0,1,
    1,0,0,0,0,0,0,"char2",0,0,0,0,1,0,0,0,0,0,0,0,0,0,0,0,1,
    1,0,0,0,0,0,0,0,0,0,0,0,1,0,0,0,"t",0,0,0,0,0,0,0,1,
    1,1,1,1,1,1,1,1,1,1,1,1,1,1,1,1,1,1,1,1,1,1,1,1,1],
    "height": 25,
    "width": 25
  }
  