{
    "data": [
    1,1,1,1,1,1,1,1,1,1,1,1,1,1,1,1,1,1,1,1,1,1,1,1,1,
    1,0,0,0,0,0,6,6,6,6,0,0,0,0,0,1,0,0,0,0,0,0,0,0,1,
    1,0,0,0,0,0,6,6,6,6,9,0,0,0,0,1,0,0,0,0,0,0,0,0,1,
    1,0,0,0,0,0,6,6,6,6,0,0,0,0,0,1,0,0,0,0,0,0,0,0,1,
    1,0,0,0,0,0,6,6,6,6,0,0,0,0,0,1,0,0,0,0,0,0,0,0,1,
    1,0,0,0,0,0,6,6,6,6,0,0,0,0,0,0,0,0,0,0,"char1",0,0,0,1,
    1,0,0,0,0,0,6,6,6,6,0,0,0,0,0,0,0,0,0,0,0,0,0,0,1,
    1,0,0,0,0,0,6,3,3,6,0,0,0,0,0,0,0,0,0,0,0,0,0,0,1,
    1,0,0,0,0,0,6,6,6,6,0,0,0,1,0,0,0,0,0,5,0,0,0,0,1,
    1,0,0,0,0,0,0,0,0,0,0,0,0,1,0,0,0,0,0,0,0,0,0,0,1,
    1,0,0,0,0,0,0,0,0,0,0,0,0,1,0,0,0,0,0,0,0,0,0,0,1,
    1,0,0,0,0,0,0,0,0,0,1,1,1,1,1,1,4,1,1,1,1,1,1,1,1,
    1,1,0,0,0,0,0,0,0,0,1,0,0,0,0,0,0,0,0,0,0,0,0,0,1,
    1,0,0,0,0,0,0,0,0,0,1,0,0,0,0,0,0,0,0,0,0,0,0,0,1,
    1,0,0,0,0,0,0,0,0,0,1,0,0,0,0,6,6,6,6,6,6,0,0,0,1,
    1,0,0,0,0,0,0,0,0,0,1,0,0,0,0,6,6,6,6,6,6,0,0,0,1,
    1,0,0,0,0,0,0,0,0,0,1,0,0,0,0,6,6,6,6,6,6,0,0,0,1,
    1,4,1,1,1,1,1,1,1,4,1,1,1,0,0,6,6,6,6,6,6,0,0,0,1,
    1,0,0,0,0,0,0,0,0,0,0,0,1,0,0,6,6,6,6,6,6,0,0,0,1,
    1,0,0,0,0,0,0,0,0,0,0,0,1,0,0,0,0,0,6,6,0,0,0,0,1,
    1,0,0,0,0,0,0,0,0,0,0,0,1,0,0,0,0,0,6,6,0,0,0,0,1,
    1,6,6,6,6,6,6,6,6,6,6,6,1,6,6,6,6,6,6,6,0,0,0,0,1,
    1,0,0,0,0,0,0,0,0,0,0,0,1,0,0,0,0,0,0,0,0,0,0,0,1,
    1,0,0,0,0,0,0,0,0,0,0,0,1,0,0,0,0,0,0,0,0,0,0,0,1,
    1,1,1,1,1,1,1,1,1,1,1,1,1,1,1,1,1,1,1,1,1,1,1,1,1],
    "height": 25,
    "width": 25
  }
  