{
  "charnumber":3,
  "chars": ["bob","lady", "ninja"],
  "data": [
    1,1,1,1,1,1,1,1,1,1,1,1,1,1,1,1,
    1,0,0,"c2",0,0,0,0,0,0,0,0,0,0,0,1,
    1,0,0,0,0,0,0,0,0,0,0,0,0,0,0,1,
    1,0,0,0,0,0,0,0,0,0,0,0,0,0,0,1,
    1,0,0,0,0,0,0,"c3",0,0,0,0,0,0,0,1,
    1,0,0,0,0,0,0,0,0,0,0,0,0,0,0,1,
    1,0,0,0,0,0,0,0,0,0,0,0,0,0,0,1,
    1,1,1,1,1,1,1,1,1,1,1,1,1,1,1,1
  ],
  "height": 16,
  "width": 16
}